PPMPPPFFPFPWPPPPWFPPWWPPPFPPPPWFPPPPPPPPPPPPWPWPFPPPPFMPPFPFMFFPPPPWFFPPPMWWWFPWFPFPFMPWPMWPPMPPPPWP
PPMFMPPWPMPPPPPPFPPWPMPPWPFFPPFWPFMPPMFPPPPMFPPPPPPPPFFMPWPPPPMPPPPWPPPPPPFPPFPPPPPPPPFPPFMPPPPFFPPM
PPMFFMWPPWWPPPFPPPFPPPFPPPPMFPPPPWPPPFFFWPFPWFPPPPPPPMPPPPPFPFPPPPPWPPPPPPFPWPPPPMFPPFFPPWPPPFWPPWPP
PWPWPPPPFPWFPPPPPPPPPFWPMPFPPPFPPFPFPPPPPPFWPPPPPPPPFPFMPPPPPPMPPMPPPMFPPPPPMPPPMFPFPFPFPPMMPPFPPPFP
PPPPPPPPPWPPPPPFPPWPPPPPPWWFFMPWPMMFPPWPFPPPFWPPPFPPPPWPPPPPPPPPFPFPPPMPFPFFPPPMPWFMPPPFPWPPMPPPPPMF
PPPPFFMFFWFPPFFPPPPPPPFMPPPPPPFPPPFPPFFFWPPPFWFPPFPPMFMPWPPMFMFFFFPPPMPPPPPMPPPPPFPPPPFPFPPPPFPWPPPP
FPFPMPPFMPPMPPPPPWPWPFFFFPFPWPPWPPPPWPPFPPMPFPPPPPPFMPPPPPPPPPWPFPPPMPFPWPPFPPPWPPFPPPPPFPPPPPPFFMPP
PPPPPPPFMMPPFPPFFFPPMPPPPMPPPPPPMPMWPPFPPFMPFMPPPPPMPFWPPPPPPFPPPWFPPPPPWPPWPMFFPPPWPPWPPPWFPPPPWPWP
PPFPFPWMPPFPPFPFPMFFPPFPPPPWFWPPPFPFPPPPPPFPPMFFWPPPPPPPMFPPPPPFPFWPPPPPPPPFMPFPPFPPPPFWPPPFFPPPPFMP
PFPFFPPPMFMPPPPPPPFPFPPFPMPFPPMPPPPPPPWPPFPMPPPPPPPPPWPPPMPWPFWPWFPPPFMFPFMPPPPPPFPMFPPPWPMWPPWPFPPF
FWPPPPPPFMWPMPPPPPPPPPPPPFPPPPFPPPMPWPPPPWMMMPPPPPFMPFPMPPPPFPFPWPPPPPFPPPFPPWPPWPPFPFPFPMPPPPFWPPPP
PMFPFPFPPFPPPPPPPPPMPPPMPPPWWPPPPPFPMPPFMWWMPPPPPPFPPMFMPPPFPPPPPPPFPPFFWFPPPPMPPPPPMPPFPMPPFWPPPPFM
FPFPPFFWPWPPPMPPPPPFWWPPPFFPPWFPPPPPPFPMFMPFFFPPPMPPPPPPPFPFPWPPWFPMPPPPPWPPPFFPPPPPPPFPPPWPPWFPMPPM
PPFFPPPPFPFPPPPPFPFMPPPFMPPMPFMPPMPFFPFMPPPPPMPPPFPPPPFPPPWPPFPPFPPPMFPFPPPPPFPPPPWWPFWPPPPPMWPFFWPM
PPMPPPPPPPPPWWPPFMPPPPPPWPPFFWPFPFPMPPWWPPMPMFPPFPPPFPFPPMPMPFPPPMPPPPPWPFFFFPFWFPPFMPPPFFMPFPFPFPFM
PFFWPPPFPPPWMPMPPPPPPPMFPWPPWPFPPMPPWPFFMPPPPPFMPPPPPFPPMMPFPPPPWPFMFPPPPMPPPFPPPPPPPPPPPWPPPPPPWPPW
PPPWPPPMFPPPPMWPPMPPPWPPFFWFFPPPPPPPPPPWMFPPPPFPPPFPPPPPPPPPPPPPPMPMMPFWPMPWPPPPPPWPPMPPPPPPPPPPPPPP
PPMFPPPPPPMPPFFFFPPPPFPPFPPWMPPPPWPMFPPPPPPPFWPFMPPMPPPPFPMFPPPPPPPMPPPPPMMPMWWWPFFPFPPPPWPPWFPMPPFP
FMFPWPPPPFPMPPPPPPPFPPPPPPPPPPPWPPFFPFMWPPPPMPPMFPFMFPPPPWPFMFPPFPPPPPPFMFPFPPMPWWMFMPFPPPPMPPPFFPPP
MPFPFPMFPPPMPWPWPPPWPPPPFPPPWMPPPPPPPWPWPPFPFPFPPPPFPPPPWWPPFPPFPPPFPPPPFWFPWPPPWPPMPPFFFPPPPPFFPPPW
PMPPPPPPPPPPWPMFWWFPPPFPPPFPPWMPPPFPWPMPPWPPPPPPPPPPFWPPPFPPPPPPMFMPPPPWFPPPMPPPFPPPPPWPFPMPPPFWPPPW
PPPPPWPFPPWMPPFPPPMPPPPFPPMPPPPMPPFPPPPPWPPPMWPPPFPPFMPPWWPPFPPPPPWMPPPPPPWWPWPWPPPPPPPPPPPPPFPPWPWP
PPPPPPWMPPFPPPPWFPPPPFPWPPPPPPPMPPPPPPMPPPPPMPPMPPPFWWPWPPPPFFPFWPPPMWPPMPPMMWPPPWPPPPPPPFPPMPPPPPPP
PPPPFFPPPPFPWPPPPPPPMPPPPPMFPPPFPWPPPPPPPWPMPFPPWPMWPPPMPFPPPMPWPPPFPPPPPPPPMPPWFPPPFPPWFPPPWPMWPPPP
PPPWPPPMPPFPPFPPPPWPPFPPWPMPPPFPWPPPPMPPWFFPPWPFFPPPPPPPPFPFPFPPPFWPPPPPPFWPPPMFPWPPPPPFFWWPFMPFPPWW
PWPFWPPPMMFPPPPFPFPPPPFWWPFPPPPMPPPPPFPPPPPPPPPPPPPFPPFPPPPFFWPPPFPWWWMFPFFPWPPFPFPPWPPMPPFPWFWPPPWW
PPPPPWPPPPPFWPPPPPPFPPPPFPFPPFPPFPFWMPPPPPFPFPPPPPPPWPFMPPPPFPWPMPFPPWMPPPPFMPPWPPPMFPPFPPFPPPPPPPFP
PPPPPPPPFPPPPFMMPPPPMFMPPPFFMPPPMPMWFPFMPFPFFPPPPFPPMPMFPMPPPPFPMPPPWPMWPFPPWPPFPPPWPMFFPMPPPPPFPPPP
WWFFFWPPPPMFWPPPPPPPPPFMPPPPPPPPPPPPWFPWFPPMFFPPPFPPPMPPFPPPFPPFPMPPPPPPPFPPMPPMPPPFPPPFPPPPFPWPPPPP
PPPPPWPFPPFMWPMFPPPPWPPPPMPPPPFPPPPPPPPPMPMPWPMPPWWMPPPPPPPPPPPPFPPPWFPPPPMPFPFMFPFPPFPPPFFMPPPPMPFP
PPWPPPFMPPMPPPPPPPWPPPPPPPFPPMPWPPMFPPPPPPPPPFPWPPWPPPMPWFPPPPPFPPFFFPPPMPPMFPFFPPPWWPPPPFPPPPFPPWFM
FPFPPPPPPFPMPPPPMPPFMPPPMPPPPPPMFPMFPFPMFPWPPWPPPPPPPPPPMFPWMFPPPPMMPPFFFPWMFPFPPPMFFPPPFPPPPPPPMMPP
PFWPPFPPFMPPPFPFPPFFPWPFWMWPPPPFPFPFFFPPPPFWWPPPPPPPPPMPPPPPFPPPPPFPFMFPPPPMPPPPFPFPPPPPPMPPPPMPWPPW
FPPPWFPPPFPPPMPPFPPPPPPMPPPFPPMWPFWPPPPPFPPFFPFPPPPPFPPPFMPPPWPMPPMWPPFPPPPMFPPPPFPPPPPPPMPPPPFPPPPM
PPPMMPFPPMPPPPPWPMPPWPPPFMPPPPPPPMMMPPPMPPPWFPPMPPPFMMWMFWPPMPPFPPMPPFPPFPFPPPPFPMPPPPFPPPFWFPPWWFPF
PPPPFPPPPPPWFPPPPPFPPPPWFPPPPPFPPPPPPPFPPPFPPFPWPWPPFPPFPPFPPPPPPPPPPFPMPPPPMPPPMWPPPPMPPPWPFPPPPFFP
PWPWPPFPPFPPPFFPMPPPFPPPMPPFPPPPPPPPPFPFPPPMFMPPWPPMPWPPPPPPWPFPPPFPMPPPFPMPMPPMFPPPPPPMFPPPMWPMPPPP
PPPPPPPPPMMWPPMFPPPWFMFPPPPMPPPFPFPPPPMPFFPPPPPPFWWPWMFPFPFFPFPPPWPPPPPWPPPPMPMPPPPPPMPFPFPFPPPPPFWP
PFPPWFPFMPFPWFPFPMPPWFFPPWMPPPPPPWWFPFPWPPWPFFWMPPPPFPFPPPPPPMMPFMFPFPPFFPPFMPPFMPPPWMPWWPFPFWPPPPPW
PPPPPPPFFFPMPPPPPPPPWFPPPWFFPPMPPPPFWWPPFPPFFPPPPPPPMPPPMPFFPPPPPPPPFPPPFPPFMPPPFPWFPPPPMPPPFPFPWFFW
PPPPFPPMPFPPPMPPPPFPFMPPFPPFPWPPPFFPPPPPFPFPPFPWPPFPPPWMPPPPPPPPPMPPPPPMPPWPFPPPPPFFPPPPMFPPFMPPPPPP
PPFPPWPPPPMWPWFPFPPWFWPPFPFPPPMWPPMFFPPFFPPWFFPPPPPPPPPPPPPFPPMPPFMPPPPMFPPWPWPPFFWPFPFPWPPPPPFPPFMP
MMPMPMWFPPMFPFMPPPPPPPFPPFPPPPWPPMPFFWPPPMPFPWMPPPPPFWFPPPPPFFPPPFPWFPMMPPMMPPPPPPPPPPPPFFPPPPPFMMPP
PPPPPPPPMMPFMPPFPPPPPPMPPMWMPPPPPPPWFPPFFPFPPPPFPPPPPPPPPMPMPPPPMFFPFWPPFPFPPPWPMPFPPPFPPWMPPPPFPFPM
WPPPFFPPPPWFPWPPPPPPMPWPPPPMPFPPPFPPPPPPPFPFPPPPPPPPPPPFPMPPFPPFMFPMPPFPPWMPPWPPWPPFMMPWPPPPPWPPFMPF
FFPPPPPPPFPFPPPFMPFPPWMMWPWPPWFPWPPPFPPWPPWPPPPWFPFPPFFPPPMPMPPPPPPFPPPMPPPPMPPMPWPFMWPPPPPPPPPFPPFP
PMPPFPPPPPPPPPFPPMMPPPPWMFFPPMFMPPPFFPPMPPPWPFPPWMPPPPFPPFPPPPPPPFPPPWPMPPPPMFPPPWPFWWPMPPPWPPFPPPPP
MPFPFFPPFPFPPWMPPMPMPFMPPPMPMMPFPPFPPMPMPPPFFPPPPPPWPFWWFFPPPPPPMFPPPPPPPPPFPPPMFFPPMFFPFPPPPFPPPPPP
PPFFPPMPWWPPMPWPPPPFPPMPPPPMPFMWPWFPPFPPPPPPPPPPPPPMPPFFPFPMPPFPWPPPPPPMPWFPWFMPPPFPPPMPPPPPWPWFFPPM
PPPPPPPPPFPMMPPPWPPPMFPPFPPPPFPFFPPMWPPPFPWPPWPPPPPFPFPPPPFPPFPPPPFPPPWPPPPPFPFPPPPPMPPPFFPMMFPPPFPF
FPPMPPWPPPPMPPPFPMFFFPPPWPPPWPPPPFFPPPPPPPPFPFPPPPPFMPPWPPPPWWFPWPPMPPFPPMPPPPPPFPMFFMPPFPPPPFPPPPPP
PPPMPPPPMFPPPPPPWWPPPPFPFFPPPPPFPPPPFPPPPPPPMPPPFPPPPPMPPPPMPFPFMPPPFMFFPPPFFFPPPPPPPFPPPPWPPMPPPPPP
PWPWPMFPPPPMMPPPPWPPMPPWPWFPPPPFPMPPPFMPPFPPPWPPPPFPMWPFPMFFPPPPPPPFFPPPPPFWPPPPMFWPPPPFPMMWPPPPPPFP
MPPMPPPPFPPPPMPPPFPPPFPPPFFPPPMWPPPFPPPPPPPWPPFPPPPPPPPPWPPWPMPFPMWPFPPPMPPPPPWPPWPPPFPPPPPWPPPPPPPP
FPPWWPPPPWPPPPPWPPPPPPPPPPMPPPPPPPPPPPPPPFWPPPMPFPPWPPPFPPMMPPPPPPPPPPPPPMPPPPFPPMPPPPMFFPPPMPPPPPPP
PPFPPPFMPPPPPPWWPWPFPFPPFWPPPMPPMPPFPPPPFPPPPPPPMWPPWPPPPPMPPPPPPPPPPPFPPPWPPPWPWPWPFPPPWPPPPPPPPPMP
FPPPPPFPWPFPPFPPPPPPPMPPPWPPMPFPPFPPPPPPPFFPPPPPPPPPPPWFPWPPWFPPPMPFWPMPPPFPPFPMPWPPPPPPPMPFMPPPPFMP
PFPWPPWPPWPFPPFPFFPPPPPMWMFPPPPPPPPMPFPWPPMPPPPMFPPFFPPMFPPPWPPPPPWWPPPWPPPPPFPWFFPPPMPFPPMFMPFPPPMP
PFPPPPPMPPFWFPPPMPFPPPFPPMPMFPPFPWFPPPWFFFPPPMPPFPMPPFPPPPPPPMPPWFPFWPMPFPPPFPPFPPPFPFFPWPPFPFPFPWFP
PPPFPPFPPFFPPPMPPPPPPPPWPPMPPFPPPFWPPPPFPMPMPPPPPWMPPPFPPFFPPPPPPPPPFMPPPMPPPPPFWPPPFPPPPPPPPFMWFFPW
PPMFPPPPMPPFPPPPPPPMPMPFPWPPFPPPFPFMPPFPPPWPPPPPPWWPMPMFPPPPPFPPPPPMMPFFMPPPPPPPPPFPPPPFMMPMPWPPFWWF
PPPFFFPPPPPFPPPWWPFPPFFWPPMMPFPPPPFWPPPPPPFPPFMPWFPMMPPPPPPMPPFMPPMPPPWPPMPPFPPPPFFPPPPFFPPPFFPPPPMP
MPPPPWPWFMPFPPPPPPPPPPPMMPPPFPPPPWFFPPPFPFMMWPPPPFPPFPFFWPPPMFPPFMPPFPPPPPPPPPPPFFPPPPPPPPPFPFPPPWFW
PPMMPFPPPPFMPPPFPMPPMWPPPMFWWPPPFPPPWPPPPPPWPPPPPPFPPPPPPMMPPPPPPPWPFPPPPWPPFPPFPFPFFPPPPPPPPFPWPWPW
PPMPPFPPFMPPPPFPPPFWFPPWPPFPPPPFFPPPWPWMPPFWPPFPPPPPPPPPPPPPPPPPFPPPPFMPPPMPWPPPMFPPMFMPFPPFPFPPPFPP
WPPPFPPFFPPWPPPPFPMFPFPFPPPPPFPPPMPPFMPPPFFPWPPPMMPPFMPPPPPWPMWPPPPPPPPPPPPPPPWPFWPPFFPFPFFPPPPFPPPP
PFPPPWWFPFPPPPMPPPPMMPFWPFPPPPPFPPPMPPPFFPFPWPFFPPPPPPWPPMPPPFPFPPPFPPPPPPPPPPPPPPFPPPFPPPPPFWPPPPFP
PPFFWPPPPPFPPPPFWMPPMPPPPPMPWPFMPPPPPWMPWPPPPPPPMPPPPWWPWPPPWPPPPPPPFFPPPWFPFPPPPFPPPFFMFPPPFFPPPPFP
PPPMPMFFPFFPWPMPPFPMPPPPMPFPPFPPFMMWPWMPPFPPPPPPMPPPPPFFPPWPPWWWWPPPPFFPPMPPFFPPFPPPPPPPPPPFPWPPWPWW
WPPPPMPPPFPMFPMPWPFPPPPPPPMPPFPPPPPPPPPWPPMMPFPMPPPPPPFPPPPPWPPPPMPPPFPPFPPFPPFFFFFPPWPPPFWPPFWPMPPP
PPPPMFWPPWPPPPMWPWFWPPPPPPPMPPFPPPFMFPPPPMFPPPFWPFPPWPPWPPPWPPPPPFPWFPWMPMPPPPWPPPWPFPMPPPPMPFPPPWPP
PPPPFPPPFPWFPPPPMPFPMPMFPFWPPFPPPPFFMPFWPPPPPPPPPWPMPPPWPPWPPPPWPPPPPFPPWPPPPPPPFPPPPFPPPFPPWPFPPFPP
FPPMPPFFFPWPPFPFPPWPPPPFPFPPPPPPPPFFPPWPFPPFPPPPPPPPPMPPWPPMPPWPPFFPPFPPPPPPPWPMPPMMFPPPFPPMPPFPFPMP
WPPPPPPPPPPFPFWPPPPMPPPPMFFFPMFPMPWPPFPPPPFPPPPFPPPPPMFPFPPPPPMFPPPWFPPPMPPFFPPPPPFMPPPPFFPPPPFPPFPP
PPPFPMWPPPWFPPPFPPPFPPWPPPPPMFPFWPFWFFPPPMFWPFWPWPPPPPPWPPPPPPPPMFPMPPPFPPPPMMPPFPFPPMFPPPFPPPPFPPPF
